Columns: 40
Rows: 40
TileSize: 32
1111111111111111111111111111111111111111
1000000000000000000000000000000000000001
1000000000000000000000000000000000000001
1000000000000000000000000000000000000001
1000000000000000000000000000000000000001
1000000000000000000111111111111111110001
1000000000000000000000000000000000000001
1000000000000000000000000000000000000001
1000000111111111111000000000000000000001
1000000000000000000000000000000000000001
1000000000000000000000000000000000000001
1000000000000000111111111111000000000001
1000000000000000000000000000000000000001
1000000000000000000000000000000000000001
1000000000000111111110000011111111000001
1000000000000000000000000000000000000001
1000000000000000000000000000000000000001
1000000000000000000001111100000000000001
1000000000000000000000000000000000000001
1000000000000000000000000000000000000001
1000000000000000000000000111111111100001
1000000000000000000000000000000000000001
1000000000000000000000000000000000000001
1000000200000011111111111111000000000001
1000000000000000000000000000000000000001
1000000000000000000000000000000000000001
1000000000111111000000000001111110000001
1000000000000000000000000000000000000001
1000000000000000000000000000000000000001
1000000000000000000011111111111100000001
1000000000000000000000000000000000000001
1000000000000000000000000000000000000001
1000000011111110000000000000000000000001
1000000000000000000000000000000000000001
1000000000000000000000000000000000000001
1111111111111111111111111111111111111111
1111111111111111111111111111111111111111
1111111111111111111111111111111111111111
1111111111111111111111111111111111111111
1111111111111111111111111111111111111111