Columns: 40
Rows: 40
TileSize: 32
2323232323232323232323232323232323232323
4545454545454545454545454545454545454545
2300000000000000000000000000000000000023
4500000000000000000000000000000000000045
2300000000000000000000000000000000000023
4500000000000000000000000000000000000045
2300000000000000000000000000000000000023
4500000000000000000000000000000000000045
2300000000000000000000000000000000000023
4500000000000000000000000000000000000045
2300000000000000000000000000000000000023
4500000000000000000000000000000000000045
2300000000000000000000000000000000000023
4500000000000000000000000000000000000045
2300000000000000000000000000000000000023
4500000000000000000000000000000000000045
2300000000000000000000000000000000000023
4500000000000000000000000000000000000045
2300000000000000000000000000000000000023
4500000000000000000000000000000000000045
2300000000000000000000000000000000000023
4500000000000000000000000000000000000045
2300000000000000000000000000000000000023
4500000000000000000000000000000000000045
2300000000000000000000000000000000000023
4500000000000000000000000000000000000045
2300000000000000000000000000000000000023
4500000000000000000000000000000000000045
2300000000000000000000000000000000000023
4500000000000000000000000000000000000045
2300000000000000000000000000000000000023
4500000000000000000000000000000000000045
2300000000000000000000000000000000000023
4500000000000000000000000000000000000045
2300000000000000000000000000000000000023
4500000000000000000000000000000000000045
2300000000000000000000000000000000000023
4500000000000000000000000000000000000045
2323232323232323232323232323232323232323
4545454545454545454545454545454545454545