Columns: 40
Rows: 40
TileSize: 32
0000000000000000000000000000000000000000
0100000000010000000001000000000100000000
0002300010000230001000023000100002300010
0004502300000450230000045023000004502300
0001004500000100450000010045000001004500
0000000000000000000000000000000000000000
0000001010000000101000000010100000001010
0023000100002300010000230001000023000100
0045000000004500000000450000000045000000
0000000000000000000000000000000000000000
0000000000000000000000000000000000000000
0100000000010000000001000000000100000000
0002300010000230001000023000100002300010
0004502300000450230000045023000004502300
0001004500000100450000010045000001004500
0000000000000000000000000000000000000000
0000001010000000101000000010100000001010
0023000100002300010000230001000023000100
0045000000004500000000450000000045000000
0000000000000000000000000000000000000000
0000000000000000000000000000000000000000
0100000000010000000001000000000100000000
0002300010000230001000023000100002300010
0004502300000450230000045023000004502300
0001004500000100450000010045000001004500
0000000000000000000000000000000000000000
0000001010000000101000000010100000001010
0023000100002300010000230001000023000100
0045000000004500000000450000000045000000
0000000000000000000000000000000000000000
0000000000000000000000000000000000000000
0100000000010000000001000000000100000000
0002300010000230001000023000100002300010
0004502300000450230000045023000004502300
0001004500000100450000010045000001004500
0000000000000000000000000000000000000000
0000001010000000101000000010100000001010
0023000100002300010000230001000023000100
0045000000004500000000450000000045000000
0000000000000000000000000000000000000000